1
*...*.....
......*...
...*...*..
..........
...*.c....
*.....*...
...*......
..m......*
...*.*....
.*.*......
