2
*...*.....
......*...
...*...*..
..........
...*.c....
*.....*...
...*......
..m......*
...*.*....
.*.*......

..........
..........
..........
..........
.........c
..........
..........
m.........
..........
..........
